







NO ./textures/test/wall.xpm








SO ./textures/test/wall.xpm
                        WE ./textures/test/wall.xpm
        EA ./textures/test/west_wall.xpm

        F 20,           20,             20
C 200,          200,200

111111111111111111111111111111111111111111111111111111
100000000000000000000000000000000000000000000000000001
10W000000000000000000000000000000000000000000000000001
10000000001000000000000000000000000000000000000000001
100000000000000000000000000000000000000000001000000001
100000000000000000000000000000000000000000000000000001
10000000000010000000000000000001000000000000000000001
100000100000000000000001000000000000000000000000000001
100000000000000000000000000000000000000000000000000001
100010000000000000000000000000000000000000000000000001
100000000000000000000000000000000000010000000000000001
100000000000000000000000000000000000000000000000000001
111111111111111111111111111111111111111111111111111111

