







NO ./textures/test/wall.xpm








SO ./textures/test/wall.xpm
                        WE ./textures/test/wall.xpm
        EA ./textures/test/west_wall.xpm

        F 20,           255,             12
C 200,          200,200

11111111111111111111111111111111111111111111111
10000000000000000000000000000000000000000000001
10000000111111111111111111111111111111111111111
1000000000000000001
1000000000000000001
10000S0000000000001
10000000000000000011111111111111111111111111111
10000000000000000000000000000000000000000000001
10000000000000000000000000000000000000000000001
11111111111111111111111111111111111111111111111

